40:40
1111111111111111111111111111111111111111
1111111111111111111111111111111111111111
111>11111111111#################11111111
111111111111###1111111111111111###111111
1111111111##111111111111111111111##11111
1##11111##111111111111111111111111##1111
11#1111##11111111111111111111111111#1111
11#111##1111111111111111111111111111#111
11#111#11111111132111111111111111111#111
11##11111111111112111122222221111111#111
111#111111##111112111221111122211111##11
1111#111111##111121122111111112211111#11
11111111#111#11112112111##11111211111#11
11111111#111##11221121111##1111211111#11
11111111#1111#112111122111#1111211111#11
11##11###1111#122111111111##11221111#111
111####111111#121111111111##11211111#111
1111111111111#12111#111111#111211111#111
1111111111111112111##1111##11221111##111
1111#111111111122111##11##111211111#1111
1111#1111111111121111####1112111111#1111
1111#11123111111221111111112211111111111
111##11221111111121111111122111111111111
111#112211111111122211112221111111111111
111#112112222211111222222111111111111111
111#112112211221111111111111111111111111
111#1121112222111111111111111111#1111111
111#112111111221111111111111111##1111111
111#11211111112111111111111111##11111111
111#11211111112111#111##11111##111111111
111#11221111121111#1111#######1111111111
111##1122112221111#111111111111111111111
1111#1112222111111#111111111111111111111
1111##111111111111##1111111111111111<111
11111##11111111#111##1111111111111111111
111111##111111##1111##111111###111111111
1111111########1111111#######11111111111
1111111111111111111111111111111111111111
1111111111111111111111111111111111111111
1111111111111111111111111111111111111111
